                 ###                
##################>#################
#                # ##########      #
#        #########          #      #
#        #         ###### # ###    #
#        # ####### ##   # # # #    #
#        # ## #  #  #   # ### #### #
#        # ## #  ####   #        # #
#        # ## ####      ########## #
#        #       #                 #
#        ##### ###                 #
#            # #####               #
#         ####     #               #
#         #    ### #               #
################## #################
                  e                 